R 1920 1080
NO srcs/ressources/brick_HR.xpm
SO srcs/ressources/metal_HR.xpm
WE srcs/ressources/stone_HR.xpm
EA srcs/ressources/wood_HR.xpm
S srcs/ressources/teleporter.xpm
F 220,220,220
C 112,128,144
11111111111111111111111111
10000000001100000000000011
10110000011100000020000011
1001000000000000000000001111111111
1111111110110000011100000000000011
1000000000110000011101111111111111
11110111111111011100000000001
11110111111111011101010010001
11000000110101011100000010001
10002000000000001100000010021
10000000000000001101010010001
11000001110101011111011110N01
11110111111101011101111010001
11111111111111111111111111111
